1111111111111111111111111111111
1000000P00000000000000000000001
1000000000000000000C00000000011

1000000000000000000000000000011
1000000000000000000000000000011
1000000000000000000000000000011
1000000000000000000000000000011
10000000000E00000000000C0000011
1000000000000000000000000000011
1000000000000000000000000000011
1000000000000000000000000000011
1000000000000000000000000000011
1111111111111111111111111111111