11111111111111111111
10000000000000000001
10000P00000000000001
10000000000000000001
11111000000000000000
1000C000000P00000001
1000000000000000E001
11111111111111111111
