11111111111111111111
10000P00011000000001
100111100000000E0001
1C000011110000000111
11111111111111111111