11111111111111111111111
1000P000000000000000001
10000011111100000000001
10000011111100000000001
10C00000000000011111111
10000000000000011111111
10000000000000011111111
10000000000000011111111
10000000000000011111111
10000000000000011111111
10000000000000011111111
1000000000000000000E001
11111111111111111111111
