111111111111111111111111111111111111
10C0000000000000P0000000000000000001
10000000000C000000000000000000000111
111C1111111C11111111111111111111E001
111111111111111111111111111111111111
